1 4-|=
-----------|||
----||-|-||--|
-----|-|----|-
------------|-
-|---|||---|-|
--||----|--|-|
------|---|-||
-----|--------
-------||--||-
--------------
--------------
|----||-|||---
----------|---
--------|-----
