12-|^
-------||----|
----|---|-----
----|---------
-|-----|-|----
-------||-||--
------||---|--
|---|-|---|---
-|-|----|-|--|
--------------
--|-----|-----
--------|-----
|--|-----|----
----|--|--|-|-
---------|--|-
