14-| 
-----------|--
---|-----|----
---------|----
--------------
--------------
--|----------|
------------|-
--|---|----|--
-----|--------
--|-----------
|||-----------
-----|------||
-------|------
------------|-
