21-|^
-------|----|--------|----------|--|--|---
------||------------------------|---------
-------------------------------|-|-----|--
|---------|--|----------------------------
------------------------|-----|--------|--
-----------------------|------------------
-----------------------|||--------|--|---|
-------|---------|-----------------|---|--
---|-|-------|--|------------------------|
------|-------|---------------------------
--------------------|-----|---------|--|--
---|---|-------------|-----|---|----------
--------------------------------|--|------
---|------|-|-----|-----------|-|----|----
------|-|--------|---|----------------|---
-|--------------------------------------|-
------------------------------------------
|----|------|-----------|------------|----
----------|-------------------------------
-----||---|-|--||---|----------|----------
----------------|------------------------|
