10.'H
..........
.'........
..........
.'..'''...
..........
....'.....
....'.....
.......'..
..........
...'......
